XXXXXXXXXXXXXXXX
XS             X
X          XX  X
X  XXX     XX  X
X  XXX         X
X  XXX         X
X  XXX   XXX   X
X  XXX   XXX   X
X        XXX   X
X        XXX   X
X         XX   X
X    X         X
X   XXX        X
X  XXXXX       X
X             GX
XXXXXXXXXXXXXXXX