XXXXXXXXXXXXXXXX
XSX X       XX X
X X   XXXXX X  X
X X X XXXX  X XX
X X X X        X
X   X X X XXXXXX
X X X X X      X
X X XXX X XXXXXX
X X   X        X
X X X X XXXXX  X
XXX XXX X      X
X   X   X XXXXXX
X XXX X X      X
X X   XXXXX XX X
X    XX      XGX
XXXXXXXXXXXXXXXX