XXXXXXXXXXXXXXXXXXXXXXXXXX
XS    X                  X
X     X             XX   X
X  X                     X
X     X     X    XX      X
X     XXXXXXX            X
XX XXXX     X            X
X           X   XXXXXXXXXX
X           X      X     X
XXXX        X   X        X
X  X           XX  X     X
X  X  XXXXXXX        XX  X
X           X   X  X     X
X           XXXXXX XXXX XX
X                  X     X
X   X              X     X
X                  X     X
X       X          X     X
X       XXXXXXXXXXXX     X
X       X         X      X
X       X         X XXXXXX
X       X       X        X
X               X        X
X       X       X       GX
XXXXXXXXXXXXXXXXXXXXXXXXXX