XXXXXXXXXXXXXXXXXXXXXXXXX
XS                      X
X                       X
X                       X
X                       X
X                       X
X                       X
X                       X
X                       X
X                       X
X                       X
X                       X
X                       X
X                       X
X                       X
X                       X
X                       X
X                       X
X                       X
X                       X
X                       X
X                       X
X                       X
X                      GX
XXXXXXXXXXXXXXXXXXXXXXXXX